{
  "maps": [
    {
      "id": "forest_entrance",
      "name": "Forest Entrance",
      "layout": [
        [0,0,2,1,0,3,0,1,3,0,1,0,2,3,0,1,2,0,3,0],
        [0,2,0,1,0,0,0,1,0,0,1,0,0,0,0,1,0,0,0,0],
        [3,0,0,0,0,2,1,1,0,0,0,0,2,3,0,0,2,0,0,3],
        [3,1,0,2,2,2,0,0,2,0,0,2,3,0,0,2,0,2,0,0],
        [0,0,0,0,0,2,0,1,0,1,2,2,1,1,0,1,0,0,0,0],
        [1,2,0,0,0,2,3,1,0,2,0,0,2,0,2,0,0,0,0,0],
        [0,0,1,0,0,0,0,0,0,0,0,0,0,0,3,3,0,0,0,0],
        [0,2,3,0,1,2,0,3,3,3,0,0,3,0,0,0,0,1,0,0],
        [1,2,3,0,1,0,0,3,0,0,2,3,0,0,0,1,0,1,1,0],
        [1,2,0,0,0,0,2,0,3,0,0,2,0,0,0,0,0,0,0,2],
        [1,2,0,0,0,0,2,0,0,0,1,1,1,0,0,1,0,0,0,0],
        [3,0,0,3,1,1,1,0,2,1,2,2,1,1,0,1,0,0,1,3],
        [2,0,0,2,0,1,0,0,2,0,3,2,0,0,0,0,0,1,1,3],
        [0,2,0,1,1,0,0,0,0,1,2,0,2,1,1,0,0,1,1,3],
        [0,0,2,1,0,3,0,1,3,0,2,0,3,0,0,1,0,1,1,0]
      ],
      "exit": {"x": 19, "y": 14, "to": "mountain_pass"}
    },
    {
      "id": "mountain_pass",
      "name": "Mountain Pass",
      "layout": [
        [0,0,2,2,0,0,0,2,2,0,2,0,2,2,0,2,2,0,0,0],
        [0,2,0,2,0,0,0,2,0,0,2,0,0,0,0,2,0,0,0,0],
        [0,0,0,0,0,2,2,2,0,0,0,0,2,2,0,0,2,0,0,0],
        [0,1,0,2,2,2,0,0,2,0,0,2,2,0,0,2,0,2,0,0],
        [0,1,1,0,0,2,0,1,0,1,2,2,1,1,0,1,0,0,0,0],
        [1,1,0,0,0,2,0,1,0,2,0,0,2,0,2,0,0,0,0,0],
        [1,0,1,0,0,0,0,0,0,0,0,0,0,0,2,2,0,0,0,0],
        [0,2,2,0,2,2,0,2,2,2,0,0,2,0,0,0,0,2,0,0],
        [0,2,2,0,2,0,0,2,0,0,2,2,0,0,0,2,0,2,2,0],
        [0,2,0,0,0,0,2,0,2,0,0,2,0,0,0,0,0,0,0,2],
        [0,2,0,0,0,0,2,0,0,0,2,2,2,0,0,2,0,0,0,0],
        [0,0,0,2,2,2,2,0,2,2,2,2,2,2,0,2,0,0,2,0],
        [2,0,0,2,0,2,0,0,2,0,2,2,0,0,0,0,0,2,2,0],
        [0,2,0,2,2,0,0,0,0,2,2,0,2,2,2,0,0,2,2,0],
        [0,0,2,2,0,0,0,2,2,0,2,0,2,0,0,2,0,2,2,0]
      ],
      "exit": {"x": 0, "y": 0, "to": "crystal_caves"}
    },
    {
      "id": "crystal_caves",
      "name": "Crystal Caves",
      "layout": [
        [0,0,1,1,0,0,0,1,1,0,1,0,1,1,0,1,1,0,0,0],
        [0,1,0,1,0,0,0,1,0,0,1,0,0,0,0,1,0,0,0,0],
        [0,0,0,0,0,1,1,1,0,0,0,0,1,1,0,0,1,0,0,0],
        [2,2,0,1,1,1,0,0,1,0,0,1,1,0,0,1,0,1,0,0],
        [2,2,2,0,0,1,0,2,0,2,1,1,2,2,0,2,0,0,0,0],
        [2,2,0,0,0,1,0,2,0,1,0,0,1,0,1,0,0,0,0,0],
        [0,0,2,0,0,0,0,0,0,0,0,0,0,0,1,1,0,0,0,0],
        [0,1,1,0,1,1,0,1,1,1,0,0,1,0,0,0,0,1,0,0],
        [0,1,1,0,1,0,0,1,0,0,1,1,0,0,0,1,0,1,1,0],
        [0,1,0,0,0,0,1,0,1,0,0,1,0,0,0,0,0,0,0,1],
        [0,1,0,0,0,0,1,0,0,0,1,1,1,0,0,1,0,0,0,0],
        [1,0,0,1,1,1,1,0,1,1,1,1,1,1,0,1,0,0,1,0],
        [1,0,0,1,0,1,0,0,1,0,1,1,0,0,0,0,0,1,1,0],
        [0,1,0,1,1,0,0,0,0,1,1,0,1,1,1,0,0,1,1,0],
        [0,0,1,1,0,0,0,1,1,0,1,0,1,0,0,1,0,1,1,0]
      ],
      "exit": {"x": 19, "y": 7, "to": "mystic_forest"}
    },
    {
      "id": "mystic_forest",
      "name": "Mystic Forest",
      "layout": [
        [0,0,3,3,0,0,0,3,3,0,3,0,3,3,0,3,3,0,0,0],
        [0,3,0,3,0,0,0,3,0,0,3,0,0,0,0,3,0,0,0,0],
        [0,0,0,0,0,3,3,3,0,0,0,0,3,3,0,0,3,0,0,0],
        [1,1,0,3,3,3,0,0,3,0,0,3,3,0,0,3,0,3,0,0],
        [1,1,1,0,0,3,0,1,0,1,3,3,1,1,0,1,0,0,0,0],
        [3,3,0,0,0,3,0,1,0,3,0,0,3,0,3,0,0,0,0,0],
        [0,0,3,0,0,0,0,0,0,0,0,0,0,0,3,3,0,0,0,0],
        [0,3,3,0,3,3,0,3,3,3,0,0,3,0,0,0,0,3,0,0],
        [0,3,3,0,3,0,0,3,0,0,3,3,0,0,0,3,0,3,3,0],
        [0,3,0,0,0,0,3,0,3,0,0,3,0,0,0,0,0,0,0,3],
        [0,3,0,0,0,0,3,0,0,0,3,3,3,0,0,3,0,0,0,0],
        [1,0,0,3,3,3,3,0,3,3,3,3,3,3,0,3,0,0,3,0],
        [1,0,0,3,0,3,0,0,3,0,3,3,0,0,0,0,0,3,3,0],
        [0,3,0,3,3,0,0,0,0,3,3,0,3,3,3,0,0,3,3,0],
        [0,0,3,3,0,0,0,3,3,0,3,0,3,0,0,3,0,3,3,0]
      ],
      "exit": {"x": 0, "y": 14, "to": "dragon_peaks"}
    }
  ],
  "defaultSpawn": {"x": 1, "y": 1}
}