{
  "maps": [
    {
      "id": "forest_entrance",
      "name": "Forest Entrance",
      "layout": [
        [0,0,2,1,0,3,0,1,3,0,1,0,2,3,0,1,2,0,3,0],
        [0,2,0,1,0,0,0,1,0,0,1,0,0,0,0,1,0,0,0,0],
        [3,0,0,0,0,2,1,1,0,0,0,0,2,3,0,0,2,0,0,3],
        [3,1,0,2,2,2,0,0,2,0,0,2,3,0,0,2,0,2,0,0],
        [0,0,0,0,0,2,0,1,0,1,2,2,1,1,0,1,0,0,0,0],
        [1,2,0,0,0,2,3,1,0,2,0,0,2,0,2,0,0,0,0,0],
        [0,0,1,0,0,0,0,0,0,0,0,0,0,0,3,3,0,0,0,0],
        [0,2,3,0,1,2,0,3,3,3,0,0,3,0,0,0,0,1,0,0],
        [1,2,3,0,1,0,0,3,0,0,2,3,0,0,0,1,0,1,1,0],
        [1,2,0,0,0,0,2,0,3,0,0,2,0,0,0,0,0,0,0,2],
        [1,2,0,0,0,0,2,0,0,0,1,1,1,0,0,1,0,0,0,0],
        [3,0,0,3,1,1,1,0,2,1,2,2,1,1,0,1,0,0,1,3],
        [2,0,0,2,0,1,0,0,2,0,3,2,0,0,0,0,0,1,1,3],
        [0,2,0,1,1,0,0,0,0,1,2,0,2,1,1,0,0,1,1,3],
        [0,0,2,1,0,3,0,1,3,0,2,0,3,0,0,1,0,1,1,0]
      ],
      "exit": {"x": 19, "y": 14, "to": "mountain_pass"}
    },
    {
      "id": "mountain_pass",
      "name": "Mountain Pass",
      "layout": [
        [0,0,2,2,0,0,0,2,2,0,2,0,2,2,0,2,2,0,0,0],
        [0,2,0,2,0,0,0,2,0,0,2,0,0,0,0,2,0,0,0,0],
        [0,0,0,0,0,2,2,2,0,0,0,0,2,2,0,0,2,0,0,0],
        [0,1,0,2,0,2,0,0,2,0,0,2,2,0,0,2,0,2,0,0],
        [0,1,1,0,0,2,0,1,0,1,2,2,1,1,0,1,0,0,0,0],
        [1,1,0,0,0,2,0,1,0,2,0,0,2,0,2,0,0,0,0,0],
        [1,0,1,0,0,0,0,0,0,0,0,0,0,0,2,2,0,0,0,0],
        [0,2,2,0,2,2,0,2,2,2,0,0,2,0,0,0,0,2,0,0],
        [0,2,2,0,2,0,0,2,0,0,2,2,0,0,0,2,0,2,2,0],
        [0,2,0,0,0,0,2,0,2,0,0,2,0,0,0,0,0,0,0,2],
        [0,2,0,0,0,0,2,0,0,0,2,2,2,0,0,2,0,0,0,0],
        [0,0,0,2,2,2,2,0,2,2,2,2,2,2,0,2,0,0,2,0],
        [2,0,0,2,0,2,0,0,2,0,2,2,0,0,0,0,0,2,2,0],
        [0,2,0,2,2,0,0,0,0,2,2,0,2,2,2,0,0,2,2,0],
        [0,0,2,2,0,0,0,2,2,0,2,0,2,0,0,2,0,2,2,0]
      ],
      "exit": {"x": 0, "y": 0, "to": "crystal_caves"}
    },
    {
      "id": "crystal_caves",
      "name": "Crystal Caves",
      "layout": [
        [0,0,1,1,0,0,0,1,1,0,1,0,1,1,0,1,1,0,0,0],
        [0,1,0,1,0,0,0,1,0,0,1,0,0,0,0,1,0,0,0,0],
        [0,0,0,0,0,1,1,1,0,0,0,0,1,1,0,0,1,0,0,0],
        [2,2,0,0,1,1,0,0,1,0,0,1,1,0,0,1,0,1,0,0],
        [2,2,2,0,0,1,0,2,0,2,1,1,2,2,0,2,0,0,0,0],
        [2,2,0,0,0,1,0,2,0,1,0,0,1,0,1,0,0,0,0,0],
        [0,0,2,0,0,0,0,0,0,0,0,0,0,0,1,1,0,0,0,0],
        [0,1,1,0,1,1,0,1,1,1,0,0,1,0,0,0,0,1,0,0],
        [0,1,1,0,1,0,0,1,0,0,1,0,0,0,0,1,0,1,1,0],
        [0,1,0,0,0,0,1,0,1,0,0,1,0,0,0,0,0,0,0,1],
        [0,1,0,0,0,0,1,0,0,0,1,1,1,0,0,1,0,0,0,0],
        [1,0,0,1,1,1,1,0,1,1,1,1,1,1,0,1,0,0,1,0],
        [1,0,0,1,0,1,0,0,1,0,1,1,0,0,0,0,0,1,1,0],
        [0,1,0,1,1,0,0,0,0,1,1,0,1,1,1,0,0,1,1,0],
        [0,0,1,1,0,0,0,1,1,0,1,0,1,0,0,1,0,1,1,0]
      ],
      "exit": {"x": 19, "y": 7, "to": "mystic_forest"}
    },
    {
      "id": "mystic_forest",
      "name": "Mystic Forest",
      "layout": [
        [0,0,3,3,0,0,0,3,3,0,3,0,3,3,0,3,3,0,0,0],
        [0,3,0,3,0,0,0,3,0,0,3,0,0,0,0,3,0,0,0,0],
        [0,0,0,0,0,3,3,3,0,0,0,0,3,3,0,0,3,0,0,0],
        [1,1,0,3,3,3,0,0,3,0,0,3,3,0,0,3,0,3,0,0],
        [1,1,0,0,0,3,0,1,0,1,3,3,1,1,0,1,0,0,0,0],
        [3,3,0,0,0,3,0,1,0,3,0,0,3,0,3,0,0,0,0,0],
        [0,0,3,0,0,0,0,0,0,0,0,0,0,0,3,3,0,0,0,0],
        [0,3,3,0,3,3,0,3,3,3,0,0,3,0,0,0,0,3,0,0],
        [0,3,3,0,3,0,0,3,0,0,3,3,0,0,0,3,0,3,3,0],
        [0,3,0,0,0,0,3,0,3,0,0,3,0,0,0,0,0,0,0,3],
        [0,3,0,0,0,0,3,0,0,0,3,3,3,0,0,3,0,0,0,0],
        [1,0,0,3,3,3,3,0,3,3,3,3,3,3,0,3,0,0,3,0],
        [1,0,0,3,0,3,0,0,3,0,3,3,0,0,0,0,0,3,3,0],
        [0,3,0,3,3,0,0,0,0,3,3,0,3,3,3,0,0,3,3,0],
        [0,0,3,3,0,0,0,3,3,0,3,0,3,0,0,3,0,3,3,0]
      ],
      "exit": {"x": 0, "y": 14, "to": "dragon_peaks"}
    },
  {
    "id": "dragon_peaks",
    "name": "Dragon Peaks", 
    "layout": [
      [2,2,2,2,0,0,0,2,2,0,2,0,2,2,0,2,2,0,2,0],
      [2,2,0,2,0,0,0,2,0,0,2,0,0,0,0,2,0,0,2,0],
      [2,0,0,0,0,2,2,2,0,0,0,0,2,2,0,0,2,0,2,0],
      [2,2,0,0,2,2,0,0,2,0,0,2,2,0,0,2,0,2,0,0],
      [2,2,2,0,0,2,0,2,0,2,2,2,2,2,0,2,0,0,2,0],
      [2,2,0,0,0,2,0,2,0,2,0,0,2,0,2,0,0,0,2,0],
      [2,0,2,0,0,0,0,0,0,0,0,0,0,0,2,2,0,0,0,0],
      [0,2,2,0,2,2,0,2,2,2,0,0,2,0,0,0,0,2,2,0],
      [0,2,2,0,2,0,0,2,0,0,2,2,0,0,0,2,0,2,2,0],
      [0,2,0,0,0,0,2,0,2,0,0,2,0,0,0,0,0,0,0,2],
      [0,2,0,0,0,0,2,0,0,0,2,2,2,0,0,2,0,2,2,0],
      [0,0,0,2,2,2,2,0,2,2,2,2,2,2,0,2,0,2,0,0],
      [2,0,0,2,0,2,0,0,2,0,2,2,0,0,0,0,0,2,0,2],
      [2,2,0,2,2,0,0,0,0,2,2,0,2,2,2,0,0,0,0,2],
      [2,2,2,2,0,0,0,2,2,0,2,0,2,0,0,2,0,2,0,2]
    ],
    "exit": {"x": 19, "y": 7, "to": "lava_caves"}
  },
  {
    "id": "lava_caves",
    "name": "Lava Caves",
    "layout": [
      [1,1,1,1,0,0,0,1,1,0,1,0,1,1,0,1,1,0,1,1],
      [1,1,0,1,0,0,0,1,0,0,1,0,0,0,0,1,0,0,1,1],
      [1,0,0,0,0,1,1,1,0,0,0,0,1,1,0,0,1,0,1,1],
      [1,1,0,0,1,1,0,0,1,0,0,1,1,0,0,1,0,1,1,1],
      [1,1,1,0,0,1,0,1,0,1,1,1,1,1,0,1,0,0,1,1],
      [1,1,0,0,0,1,0,1,0,1,0,0,1,0,1,0,0,0,1,1],
      [1,0,1,0,0,0,0,0,0,0,0,0,0,0,1,1,0,0,1,1],
      [0,1,1,0,1,1,0,1,1,1,0,0,1,0,0,0,0,0,0,0],
      [0,1,1,0,1,0,0,1,0,0,1,1,0,0,0,1,0,1,1,1],
      [0,1,0,0,0,0,1,0,1,0,0,1,0,0,0,0,0,1,1,1],
      [0,1,0,0,0,0,1,0,0,0,1,1,1,0,0,1,0,1,1,1],
      [0,0,0,1,1,1,1,0,1,1,1,1,1,1,0,1,0,1,1,1],
      [1,0,0,1,0,1,0,0,1,0,1,1,0,0,0,0,0,1,1,1],
      [1,1,0,1,1,0,0,0,0,1,1,0,1,1,1,0,0,1,1,1],
      [1,1,1,1,0,0,0,1,1,0,1,0,1,0,0,1,0,1,1,1]
    ],
    "exit": {"x": 19, "y": 7, "to": "frost_cavern"}
  },
    {
   "id": "frost_cavern",
   "name": "Frost Cavern",
   "layout": [
     [2,2,1,1,0,0,0,1,1,0,1,0,1,1,0,1,1,0,2,2],
     [2,1,0,1,0,0,0,1,0,0,1,0,0,0,0,1,0,0,2,2],
     [2,0,0,0,0,1,1,1,0,0,0,0,1,1,0,0,1,0,2,2],
     [2,1,0,1,1,1,0,0,1,0,0,1,1,0,0,1,0,1,2,2],
     [2,1,0,0,0,1,0,1,0,1,1,1,1,1,0,1,0,0,2,2],
     [2,1,0,0,0,1,0,1,0,1,0,0,1,0,1,0,0,0,2,2],
     [2,0,1,0,0,0,0,0,0,0,0,0,0,0,1,1,0,0,2,2],
     [0,1,1,0,1,1,0,1,1,1,0,0,1,0,0,0,0,0,0,0],
     [0,1,1,0,1,0,0,1,0,0,1,1,0,0,0,1,0,2,2,2],
     [0,1,0,0,0,0,1,0,1,0,0,1,0,0,0,0,0,2,2,2],
     [0,1,0,0,0,0,1,0,0,0,1,1,1,0,0,1,0,2,2,2],
     [0,0,0,1,1,1,1,0,1,1,1,1,1,1,0,1,0,2,2,2],
     [1,0,0,1,0,1,0,0,1,0,1,1,0,0,0,0,0,2,2,2],
     [1,1,0,1,1,0,0,0,0,1,1,0,1,1,1,0,0,2,2,2],
     [2,2,1,1,0,0,0,1,1,0,1,0,1,0,0,1,0,2,2,2]
   ],
   "exit": {"x": 19, "y": 7, "to": "demon_lair"}
  },
  {
   "id": "demon_lair",
   "name": "Demon's Lair",
   "layout": [
     [1,1,1,1,0,0,0,1,1,0,1,0,1,1,0,1,1,0,1,1],
     [1,0,0,1,0,0,0,1,0,0,1,0,0,0,0,1,0,0,1,1],
     [1,0,0,0,0,2,2,2,0,0,0,0,2,2,0,0,2,0,1,1],
     [1,1,0,0,2,2,0,0,2,0,0,2,2,0,0,2,0,2,1,1],
     [1,2,2,0,0,2,0,1,0,1,2,2,1,1,0,1,0,0,1,1],
     [1,2,0,0,0,2,0,1,0,2,0,0,2,0,2,0,0,0,1,1],
     [1,0,2,0,0,0,0,0,0,0,0,0,0,0,2,2,0,0,1,1],
     [0,2,2,0,2,2,0,2,2,2,0,0,2,0,0,0,0,0,0,0],
     [0,2,2,0,2,0,0,2,0,0,2,2,0,0,0,2,0,2,1,1],
     [0,2,0,0,0,0,2,0,2,0,0,2,0,0,0,0,0,1,1,1],
     [0,2,0,0,0,0,2,0,0,0,2,2,2,0,0,2,0,1,1,1],
     [0,0,0,2,2,2,2,0,2,2,2,2,2,2,0,2,0,1,1,1],
     [2,0,0,2,0,2,0,0,2,0,2,2,0,0,0,0,0,1,1,1],
     [2,2,0,2,2,0,0,0,0,2,2,0,2,2,2,0,0,1,1,1],
     [2,2,2,2,0,0,0,2,2,0,2,0,2,0,0,2,0,1,1,1]
   ],
   "exit": {"x": 19, "y": 7, "to": "final_sanctum"}
  },
  {
   "id": "final_sanctum", 
   "name": "Final Sanctum",
   "layout": [
     [3,3,3,3,0,0,0,3,3,0,3,0,3,3,0,3,3,0,3,3],
     [3,0,0,3,0,0,0,3,0,0,3,0,0,0,0,3,0,0,3,3],
     [3,0,0,0,0,3,3,3,0,0,0,0,3,3,0,0,3,0,3,3],
     [3,3,0,3,3,3,0,0,3,0,0,3,3,0,0,3,0,3,3,3],
     [3,3,0,0,0,3,0,3,0,3,3,3,3,3,0,3,0,0,3,3],
     [3,3,0,0,0,3,0,3,0,3,0,0,3,0,3,0,0,0,3,3],
     [3,0,3,0,0,0,0,0,0,0,0,0,0,0,3,3,0,0,3,3],
     [0,3,3,0,3,3,0,3,3,3,0,0,3,0,0,0,0,0,0,0],
     [0,3,3,0,3,0,0,3,0,0,3,3,0,0,0,3,0,3,3,3],
     [0,3,0,0,0,0,3,0,3,0,0,3,0,0,0,0,0,3,3,3],
     [0,3,0,0,0,0,3,0,0,0,3,3,3,0,0,3,0,3,3,3],
     [0,0,0,3,3,3,3,0,3,3,3,3,3,3,0,3,0,3,3,3],
     [3,0,0,3,0,3,0,0,3,0,3,3,0,0,0,0,0,3,3,3],
     [3,3,0,3,3,0,0,0,0,3,3,0,3,3,3,0,0,3,3,3],
     [3,3,3,3,0,0,0,3,3,0,3,0,3,0,0,3,0,3,3,3]
   ],
   "exit": {"x": 19, "y": 7, "to": "victory"}
  },
    {
   "id": "victory",
   "name": "Victory Hall",
   "layout": [
     [3,3,0,0,0,3,3,3,3,3,3,3,3,3,3,3,3,3,3,3],
     [3,0,0,0,0,0,0,3,3,3,3,3,3,3,3,3,3,3,3,3],
     [0,0,0,0,0,0,0,0,3,3,3,3,3,3,3,3,3,3,3,3],
     [0,0,0,0,0,0,0,0,0,3,3,3,3,3,3,3,3,3,3,3],
     [0,0,0,0,0,0,0,0,0,0,3,3,3,3,3,3,3,3,3,3],
     [0,0,0,0,0,0,0,0,0,0,0,3,3,3,3,3,3,3,3,3],
     [0,0,0,0,0,0,0,0,0,0,0,0,3,3,3,3,3,3,3,3],
     [0,0,0,0,0,0,0,0,0,0,0,0,0,3,3,3,3,3,0,0],
     [0,0,0,0,0,0,0,0,0,0,0,0,0,0,3,3,3,3,0,3],
     [0,0,0,0,0,0,0,0,0,0,0,0,0,0,0,3,3,3,0,3],
     [0,0,0,0,0,0,0,0,0,0,0,0,0,0,0,0,3,3,0,0],
     [0,0,0,0,0,0,0,0,0,0,0,0,0,0,0,0,0,3,3,0],
     [0,0,0,0,0,0,0,0,0,0,0,0,0,0,0,0,0,0,3,0],
     [0,0,0,0,0,0,0,0,0,0,0,0,0,0,0,0,0,0,0,0],
     [0,0,0,0,0,0,0,0,0,0,0,0,0,0,0,0,0,0,0,0]
   ],
   "exit": {"x": 19, "y": 14, "to": "secret_garden"}
  },
  {
   "id": "secret_garden",
   "name": "Secret Garden",
   "layout": [
     [3,3,3,3,3,3,3,3,3,3,3,3,3,3,3,3,3,3,3,3],
     [3,0,0,0,0,0,0,0,0,0,0,0,0,0,0,0,0,0,0,3],
     [3,0,3,3,3,3,3,3,3,3,3,3,3,3,3,3,3,3,0,3],
     [3,0,3,0,0,0,0,0,0,0,0,0,0,0,0,0,0,3,0,3],
     [3,0,3,0,3,3,3,3,3,3,3,3,3,3,3,3,0,3,0,3],
     [3,0,3,0,3,0,0,0,0,0,0,0,0,0,0,3,0,3,0,3],
     [3,0,3,0,3,0,3,3,3,3,3,3,3,3,0,3,0,3,0,3],
     [3,0,3,0,3,0,3,0,0,0,0,0,0,3,0,3,0,3,0,3],
     [3,0,3,0,3,0,3,0,3,3,3,3,0,3,0,3,0,3,0,3],
     [3,0,3,0,3,0,3,0,3,0,0,3,0,3,0,3,0,3,0,3],
     [3,0,3,0,3,0,3,0,3,0,0,3,0,3,0,3,0,3,0,3],
     [3,0,3,0,3,0,3,0,3,3,3,3,0,3,0,3,0,3,0,3],
     [3,0,3,0,3,0,0,0,0,0,0,0,0,3,0,3,0,3,0,3],
     [3,0,3,0,3,3,3,3,3,3,3,3,3,3,0,3,0,0,0,3],
     [3,0,0,0,0,0,0,0,0,0,0,0,0,0,0,3,3,3,3,3]
   ],
   "exit": null
  }
    
    
    
    
  ],
  "defaultSpawn": {"x": 1, "y": 1}
}